NO ./img/Cub3d_wall.png
SO ./img/Cub3d_wall.png
WE ./img/Cub3d_wall.png
EA ./img/Cub3d_wall.png

F 220,100,0
C 225,30,0

11111111111111111111111111111
10000000001100000000000000101
1011000001110100000N000010111
10010000000000000000000010001
10110000011100000000000010001
10000000001100000111011110001
11110111111111011100000010001
11110111111111011101010010001
11000000110101011100000010001
10000000000000001100000010001
10000000000000001101010010001
11000000110101000000000000001
11110111110101000000000000001
10000000001100000100000010001
10000000000000001010000101001
10000000001000010001010001001
10000000001101000000000000111
10000000000100000001010000101
11111111111111111111111111111