
WE ./img/GOATx.png
EA ./img/TROUTx.png

F 127,127,127
C 150,170,80

111     1111111111111111111111111
101     1000000000110000000000001
111     1011000001110000000000001
        1001000000000000000000001
111111111011000001110000000000001
100000000011000001110111111111111
111101111111110111  100010001
11110111111111011111010010001
 NO ./img/GOATx.png
 SO ./img/Cub3d_wall.png
11000000110101011100000010001
10000000000000001100000010001
10000000000000001101010010001
11000001110101011111011110N0111
11110111 1110101 101111010001
11111111 1111111 111111111111