NO ./img/Cub3d_wall.png
SO ./img/Cub3d_wall.png
WE ./img/Cub3d_wall.png
EA ./img/Cub3d_wall.png

F 220,100,0
C 225,30,0

1111
10N
1111