NO ./img/GOATx.png
SO ./img/TROUTx.png
WE ./img/OTTERx.png
EA ./img/FOXx.png

          F 220,100,0
C 225,30,0

 111    11111111111             11111111111111
 101    10000000001             10000000000001
 111    10110000011             10000000000001
        10010000001             10000000000001
1111111110110000011             10000000000001
1000000000110000011             10111111111111
111101111111110111  111111111
11110111111111011111010010001
11000000110101011100000010001
10000000000000001100000010001
10000000000000001101010010001
11000001110101011111011110N0111
11110111 1110101 101111010001
11111111 1111111 111111111111