NO ./img/GOATx.png
SO ./img/TROUTx.png
WE ./img/OTTERx.png
EA ./img/FOXx.png

F 220,100,0
C 225,30,0

1111
10N1
1111