NO ./img/wall_03.png
SO ./img/wall_03.png
WE ./img/wall_03.png
EA ./img/wall_03.png
DO ./img/wall_01.png

          F 220,100,0
C 225,30,0

 111    1111111111111111111111111
 101    1000000000110000000000001
 111    1011000001110000000000001
        10010000000000000W0000001
111111111011000001110000000000001
100000000011000001110111111111111
111101111111110111  100010001
11110111111111011111010010001
11000000110101011100000010001
10000000000000000000000010001
10000000000000001101010010001
1100000111010101111101101000111
11110111 1110101 101111000001