NO /Users/gbaumgar/Cursus/cub3D/img/background.png
SO /Users/gbaumgar/Cursus/cub3D/img/collectible.png
WE /Users/gbaumgar/Cursus/cub3D/img/exit.png
EA /Users/gbaumgar/Cursus/cub3D/img/wall.png
DO /Users/gbaumgar/Cursus/cub3D/img/player.png

                    F 169,0,169
C 128,128,128

111ok
 111    1111111111111111111111111
 101    1000000000110000000000001
 111    1011000E01110000000000001
        1001000000000000000000001
111111111011000001110000000000001
100000000011000001110111111111111
111101111111110111  100010001
11110111111111011111010010001
11000000110101011100000010001
10000000000000001100000010001
10000000000000001101010010001
1100000111010101111101111000111
11110111 1110101 101111010001
11111111 1111111 111111111111