NO ./img/wall_02.png
SO ./img/wall_02.png
WE ./img/wall_01.png
EA ./img/wall_01.png
DO ./img/wall_01.png

                    F 119,181,254
C 128,128,128

111ok
 111    1111111111111111111111111
 101    1000000000110000000000001
 111    101100E001111000000000001
        1001000000DDD00000000001
111111111011000001111000000000001
100000000011000001110110111111111
111101111111110111  100010001
11110111111111D11111010010001
11000000110101011100000010001
10000000000000000D000000D0001
10000000000000001101010010001
1100000111010101111101111000111
11110111 1110101 101111010001
11111111 1111111 111111111111