NO ./img/OTTERx.png
SO ./img/FOXx.png
WE ./img/GOATx.png
EA ./img/TROUTx.png

          F 220,100,0
C 225,30,0

 111    1111111111111111111111111
 101    1000000000110000000000001
 111    1011000001110000000000001
        10010000000000000E0000001
111111111011000001110000000000001
100000000011000001110111111111111
111101111111110111  100010001
11110111111111011111010010001
11000000110101011100000010001
10000000000000000000000010001
10000000000000001101010010001
1100000111010101111101101000111
11110111 1110101 101111000001
11111111 1111111 111111111111