NO ./img/Cub3d_wall.png
SO ./img/Cub3d_wall.png
WE ./img/Cub3d_wall.png
EA ./img/Cub3d_wall.png

          F 220,100,0
C 225,30,0

111ok
 111    1111111111111111111111111
 101    10000000E0110000000000001
 111    1011000001110000000000001
        1001000000D00000000000001
111111111011000001110000000000001
100000000011000001110111111111111
111101111111110111  100010001
11110111111111D11111010010001
11000000110101011100000010001
10000000000000001100000010001
10000000000000001101010010001
1100000111010101111101111000111
11110111 1110101 101111010001
11111111 1111111 111111111111