NO ./img/wall_01.png
SO ./img/wall_02.png
WE .
EA ./img/wall_04.png
F 41,42,37
C 86,79,87


1111111111111111111111111111111111111111111111111111111111111111111111111111111111111111111111111111
1S000000D0D10001000000000000000000000000000000000000000000000000000000000000000000000000000000000001
1100001010101010100000000000000000000000000000000000000000000000000000000000000000000000000000000001
1110000000000000000000000000000000000000000000000000000000000000000000000000000000000000000000000001
1111000000000000000000000000000000000000000000000000000000000000000000000000000000000000000000000001
1111100000000000000000000000000000000000000000000000000000000000000000000000000000000000000000000001
1111110000000000000000000000000000000000000000000000000000000000000000000000000000000000000000000001
1111111000000000000000000000000000000000000000000000000000000000000000000000000000000000000000000001
1111111100000000000000000000000000000000000000000000000000000000000000000000000000000000000000000001
1111111110000000000000000000000000000000000000000000000000000000000000000000000000000000000000000001
1111111111000000000000000000000000000000000000000000000000000000000000000000000000000000000000000001
1111111111100000000000000000000000000000000000000000000000000000000000000000000000000000000000000001
1111111111110100000000000000000000000000000000000000000000000000000000000000000000000000000000000001
1111111111111000000000000000000000000000000000000000000000000000000000000000000000000000000000000001
1111111111111100000000000000000000000000000000000000000000000000000000000000000000000000000000000001
1111111111111110000000000000000000000000000000000000000000000000000000000000000000000000000000000001
1111111111111111111111111111100000000000000000000000000000000000000000000000000000000000000000000001
1111111111111111111111111111110000000000000000000000000000000000000000000000000000000000000000000001
1111111111111111111111111111111000000000000000000000000000000000000000000000000000000000000000000001
1111111111111111111111111111111100000000000000000000000000000000000000000000000000000000000000000001
1111111111111111111111111111111110000000000000000000000000000000000000000000000000000000000000000001
1111111111111111111111111111111111000000000000000000000000000000000000000000000000000000000000000001
1000000000000000000000000000000000000000000000000000000000000000000000000000000000000000000000000001
1000000000000000000000000000000000000000000000000000000000000000000000000000000000000000000000000001
1000000000000000000000000000000000000000000000000000000000000000000000000000000000000000000000000001
1000000000000000000000000000000000000000000000000000000000000000000000000000000000000000000000000001
1000000000000000000000000000000000000000000000000000000000000000000000000000000000000000000000000001
1000000000000000000000000000000000000000000000000000000000000000000000000000000000000000000000000001
1000000000000000000000000000000000000000000000000000000000000000000000000000000000000000000000000001
1000000000000000000000000000000000000000000000000000000000000000000000000000000000000000000000000001
1000000000000000000000000000000000000000000000000000000000000000000000000000000000000000000000000001
1000000000000000000000000000000000000000000000000000000000000000000000000000000000000000000000000001
1000000000000000000000000000000000000000000000000000000000000000000000000000000000000000000000000001
1000000000000000000000000000000000000000000000000000000000000000000000000000000000000000000000000001
1000000000000000000000000000000000000000000000000000000000000000000000000000000000000000000000000001
1000000000000000000000000000000000000000000000000000000000000000000000000000000000000000000000000001
1000000000000000000000000000000000000000000000000000000000000000000000000000000000000000000000000001
1000000000000000000000000000000000000000000000000000000000000000000000000000000000000000000000000001
1000000000000000000000000000000000000000000000000000000000000000000000000000000000000000000000000001
1000000000000000000000000000000000000000000000000000000000000000000000000000000000000000000000000001
1000000000000000000000000000000000000000000000000000000000000000000000000000000000000000000000000001
1000000000000000000000000000000000000000000000000000000000000000000000000000000000000000000000000001
1000000000000000000000000000000000000000000000000000000000000000000000000000000000000000000000000001
1111111111111111111111111111111111111111111111111111111111111111111111111111111111111111111111111111